NO ./textures/Ground_01.xpm
SO ./textures/Ground_02.xpm
WE ./textures/Ground_03.xpm
EA ./textures/Ground_04.xpm

F 175,127,65
C 89,94,239

        1111111111111111111111111
        1000000000110000000000001
        1011000001110000000000001
        1001000000000000000000001
111111111011000001111000000000001
100000000011000001110101111111111
11110111111111011100000010001
1111N111111111011101010010001
11000000110101011100000010001
10000000000000000000000010001
10000000000000001101010010001
1100000111010101111101011000111
11110111 1110101 101110000001
11111111 1111111 111111111111
