111111111111
10000C000001
100011111001
100010001001
100000100001
100010001001
1P00111110E1
111111111111