111111111111
1e00000000e1
100011111001
1000100e1001
100000100001
100010001001
1P0C111110E1
111111111111